111111111111111111111111111111111
100000000000000000000000000010001
100000000000000000000000000010001
100000000000000000001111111110001
100000000000010000000000000000001
100000000000010000000000000000001
100001111111110000000000000000001
100000000000000000000000000000001
100000000000000000011111100000001
100000000000000000000000100000001
100000000000000000000000100000001
100000000000000000000000100000001
100001111111111000000000100000001
100000000000000000000000000000001
100000000000000000000000000000001
100000000000000000000001111110001
100000000000000000000000000010001
100000000000000000000000000010001
100000000111100000000000000010001
100000000100000000000000000010001
100000000100000000001111111110001
100000000100000000000000000000001
100000000100000000000000000000001
100111111100000P00000000000000001
100000000000000000000000000000001
100000000000000000000000000000001
111111111111111111111111111111111